[console_scripts]
alertengine = invenio.legacy.webalert.scripts.alertengine:main
arxiv-pdf-checker = invenio.legacy.pdfchecker:main
batchuploader = invenio.legacy.bibupload.scripts.batchuploader
bibauthorid = invenio.legacy.bibauthorid.scripts.bibauthorid:main
bibcatalog = invenio.legacy.bibcatalog.scripts.bibcatalog:main
bibcheck = invenio.legacy.bibcheck.scripts.bibcheck:main
bibcircd = invenio.legacy.bibcirculation.scripts.bibcircd:main
bibclassify = invenio.modules.classifier.scripts.classifier:main
bibconvert = invenio.legacy.bibconvert.scripts.bibconvert:main
bibdocfile = invenio.legacy.bibdocfile.scripts.bibdocfile:main
bibedit = invenio.legacy.bibedit.scripts.bibedit:main
bibencode = invenio.modules.encoder.scripts.encoder:main
bibexport = invenio.legacy.bibexport.scripts.bibexport:main
bibindex = invenio.legacy.bibindex.scripts.bibindex:main
bibmatch = invenio.legacy.bibmatch.scripts.bibmatch:main
bibrank = invenio.legacy.bibrank.scripts.bibrank:main
bibrankgkb = invenio.legacy.bibrank.scripts.bibrankgkb:main
bibreformat = invenio.legacy.bibformat.scripts.bibreformat:main
bibsched = invenio.legacy.bibsched.scripts.bibsched:main
bibsort = invenio.legacy.bibsort.scripts.bibsort:main
bibstat = invenio.legacy.bibindex.scripts.bibstat:main
bibtaskex = invenio.legacy.bibsched.scripts.bibtaskex:main
bibtasklet = invenio.legacy.bibsched.scripts.bibtasklet:main
bibtex = invenio.modules.sequencegenerator.scripts.bibtex:main
bibupload = invenio.legacy.bibupload.scripts.bibupload:main
convert_journals = invenio.legacy.docextract.scripts.convert_journals:main
dbdump = invenio.legacy.miscutil.scripts.dbdump:main
dbexec = invenio.legacy.miscutil.scripts.dbexec:main
docextract = invenio.legacy.docextract.scripts.docextract:main
elmsubmit = invenio.legacy.elmsubmit.scripts.elmsubmit:main
gotoadmin = invenio.modules.redirector.scripts.redirector:main
hepdataharvest = invenio.utils.hepdata.scripts.hepdataharvest:main
inveniocfg = invenio.legacy.inveniocfg:main
inveniogc = invenio.legacy.websession.scripts.inveniogc:main
inveniomanage = invenio.base.manage:main
inveniounoconv = invenio.legacy.websubmit.scripts.inveniounoconv:main
oaiharvest = invenio.legacy.oaiharvest.scripts.oaiharvest:main
oairepositoryupdater = invenio.legacy.oairepository.scripts.oairepositoryupdater:main
plotextractor = invenio.utils.scripts.plotextractor:main
refextract = invenio.legacy.refextract.scripts.refextract:main
textmarc2xmlmarc = invenio.legacy.bibrecord.scripts.textmarc2xmlmarc:main
webaccessadmin = invenio.modules.access.scripts.webaccessadmin:main
webauthorprofile = invenio.legacy.webauthorprofile.scripts.webauthorprofile:main
webcoll = invenio.legacy.websearch.scripts.webcoll:main
webmessageadmin = invenio.legacy.webmessage.scripts.webmessageadmin:main
webstatadmin = invenio.legacy.webstat.scripts.webstatadmin:main
websubmitadmin = invenio.legacy.websubmit.scripts.websubmitadmin:main
xmlmarc2textmarc = invenio.legacy.bibrecord.scripts.xmlmarc2textmarc:main
xmlmarclint = invenio.legacy.bibrecord.scripts.xmlmarclint:main

[distutils.commands]
inveniomanage = invenio.base.setuptools:InvenioManageCommand

